WGGGGGGGGGGGGGGGGGGGGGGGGGGGGW
WGGGGGGGGGGGGGGGGGGGGGGGGGGGGW
WWWWWWWWWWWWWWWWWWWWWWWWWWWWWW
WGHGGGGGGG G GW GGGGGGGGGGGGGW
WGGGGGGGGG G GW GG GGGGGGGGGGW
WO OO       W  O  O   W *GGGGW
WOWGOG G    W         W    * W
WOWGOG  	     *WGGGGGWW
WWWWWW W    W   G     W  W   W				l*L
W               O O   WGGGGGWW				21*30
WGWGGG G    W         WGGGGWGW
W WGGG G    W         WW    GW
WGWGGG G    W        W      GW
WGWGGG G    W         W      W
WGWGGG G    W         W GGGGWW
W                     WW WWW*W
GGGGGGGGGGGWGGGGGGGGGGGGGGGGGW
GG          *GGWGGGGG*GGGGGGGW
GGGGGGGGGGGGGGGWGGGGGGGGGGGGGW
WGGWGGGGWGGWGGG*W GGGGGGGGGGGW
WWWWWWWWWWWWWWWWWWWWWWWWWWWWWW