WGGGGGGGGGGGGGGGGGGGGGGGGGGGGGGGGGGGGGGGW
WGGGGGGGGGGGGGGGGGGGGGGGGGGGGGGGGGGGGGGGW
WWWWWWWWWWWWWWWWWWWWWWWWWWWWWWWWWWWWWWWWW
WGHGGGGGGG G GW GGGGGGGGGGGGGGGGGGGGGGGGW
WGGGGGGGGG G GW GG GGGGGGGGGGGGGGGGGGGGGW
WO OO       W  O  O   W *GGGGGGGGGGGGGGOW
WOWGOG G    W         W               * W
WOWGOG               *WGGGGGGGGGGGGGGGGWW
WWWWWW W    W   G     W          W      W				l*L
W               O O   WGGGG*GGGGGG  WW WW				21*42
WGWGGG G    W         WGGGGGGGGGGGGGGWGGW'
W WGGG G    W         W        W       GW
WGWGGG G    W         W         W      GW
WGWGGG G    W         W          W     GW
WGWGGG G    W         W GGGGGGGGGGGGGGGGW
W                     WW WWWWWWWWWWWWWW*W
GGGGGGGGGGGGGGGGGGGGGGWGGGGGGGGGGGGGGGGGW
GG          *GGGGGGGGGWGGGGGGGGG*GGGGGGGW
GGGGGGGGGGGGGGGGGGGGGGWGGGGGGGGGGGGGGGGGW
WGGWGGGGOGGWGGO GGGWGGWGGG*W GGGGGGGGGGGW
WWWWWWWWWWWWWWWWWWWWWWWWWWWWWWWWWWWWWWWWW