GGGGGGGGGGGGGGGGGGGGGGGGGGGGGGGGGGGGG
GGGGGGGGGGGGGGGGGGGGGGGGGGGGGGGGGGGGG
GGGGGGGGGGGGGGGGGGGGGGGGGGGGGGGGGGGGG
GGGGGGGGGGGGGGGGGGGGGGGGGGGGGGGGGGGGG
GGGGWWWWWWWWWWWWWWWWWWWWWWWWWWWWWGGGG      
GGGGWGGGGGGGGOGGGGGGGGG*GGGGGOGGWGGGG
GGGGWGGGGGGGOGGGGOGGGGGGGG   GGGWGGGG
GGGGWOGGGGGGGGGWGGGGGGOGGG M GGGWGGGG
GGGGWGGOGGGGGG*WGGGGGGGGGG   GGGWGGGG
GGGGWGGGGGGGGGGWGOGGGGGGG*GGGGOGWGGGG
GGGGWGGGGOGGGGOWGGGGGGG   GOGGGGWGGGG          37 x 25
GGGGWGGGGGGGGGGWGGGGGGG M GGGGGGWGGGG          2 (HEIGHT) 
GGGGWGOOGGGG*GGGOG   GG   GGGGOGWGGGG          0 (WIDTH)
GGGGWGGG   GGGGGOG M GGGGGOGOGGGWGGGG
GGGGWGGG M GGGGOGG   G   GGGGGGGWGGGG
GGGGWGGG   GGGGGGGGGGG M GGGOGGGWGGGG
GGGGWGGGGGGGGGGG*GGGGG   GGGGGGGWGGGG
GGGGWGGGOGGGOGGGGGGGOGGGGGGGGGGGWGGGG
GGGGWGGGGOGGGGGGGGGGGGGOGGGGGOGGWGGGG
GGGGWGGGGGGGOGGGG   GGGGGGGGGGGGWGGGG
GGGGWGGGGGGGGGGGG M GGGGGGG*GGGGWGGGG
GGGGWGGOGGGGGGGGG   GGGOGGGGGOGWWGGGG
GGGGWWWWWWWWWWWWWWWWWWWWWWWWWWWWWGGGG
GGGGGGGGGGGGGGGGGGGGGGGGGGGGGGGGGGGGG
GGGGGGGGGGGGGGGGGGGGGGGGGGGGGGGGGGGGG