GGGGGGGGGGGGGGGGGGGGGGGGGGGGGGGGGGGGG
GGGGGGGGGGGGGGGGGGGGGGGGGGGGGGGGGGGGG
GGGGGGGGGGGGGGGGGGGGGGGGGGGGGGGGGGGGG
GGGGGGGGGGGGGGGGGGGGGGGGGGGGGGGGGGGGG
GGGGWWWWWWWWWWWWWWWWWWWWWWWWWWWWWGGGG      
GGGGWGGGGGGGGOGGGGGGGGG*GGGGGOGGWGGGG
GGGGWGGGGGGGOGGGGOGGGGGGGG   GGGWGGGG
GGGGWOGGGGGGGGGGGGGGGGOGGG M GGGWGGGG
GGGGWGGOGGGGGG*GGGGGGGGGGG   GGGWGGGG
GGGGWGGGGGGGGGGGGOGGGGGGG*GGGGOGWGGGG
GGGGWGGGOGGGGGOGGGGGGGG   GOGGOGWGGGG          37 x 25
GGGGWGGGGGGGGGGGGGGGGGG M GGGGGGWGGGG          2 (HEIGHT) 
GGGGWGOOGGGG*GGGOG   GG   GGGGGGWGGGG          0 (WIDTH)
GGGGWGGG   GGGGGOG M GGGGGOGOGGGWGGGG
GGGGWGGG M GGGGOGG   G   GGGGGGGWGGGG
GGGGWGGG   GGGGGGGGGGG M GGGOGGGWGGGG
GGGGWGGGGGGGGGGG*GGGGG   GGGGGGGWGGGG
GGGGWGGGOGGGOGGGGGGGOGGGGGGGGGGGWGGGG
GGGGWGGGGOGGGGGGGGGGGGGOGGGGGOGGWGGGG
GGGGWGGGGGGGOGGGG   GGGGGGGGGGGGWGGGG
GGGGWGGGGGGGGGGGG M GGGGGGG*GGGGWGGGG
GGGGWGGOGGGGGGGGG   GGGOGGGGGOGWWGGGG
GGGGWWWWWWWWWWWWWWWWWWWWWWWWWWWWWGGGG
GGGGGGGGGGGGGGGGGGGGGGGGGGGGGGGGGGGGG
GGGGGGGGGGGGGGGGGGGGGGGGGGGGGGGGGGGGG