WWWWWWWWWWWWWWWWWWWWWWWWWWWWWWWWWWWWW
GGGGGGGGGGOGGGGGGGGGGGGGGGGGGGGGGGGGW
GGGGGGGGGGGGGGGGGGGGGGGGGGGGGGGGGGGGW
GGGGGGGGGGGGGGGGGGGGGGGGGGGGGGGGGGGGW
WGGWWWWGGGGGGGGGGGGGGGGGGGGGGGGOGGGGW
GGGGGGGWWWWWWWWWWWWWWWWWGGGGGGGGGGGGW
GGGGGGGGGGGGGGGGGGGGOGGGGGGGGGGGGGGGW
GGG*GGGGGGGGGGGOGGGG*GGGGGGGGGGGGGGGW
GGGGGGGGGGGGGGG*GGGGGGGGGGGGWWWWGGGGW
GGGGGGGWGGGGGGGGGGGGGGGGGGGGGGGGGGGGW
GGGGGGGWGGGGGGGGGGGGGGGGGGGGGGGGOGGGW
GGGGGGGWGG*GGGGGGGGGGGGGGGGGGGGG*GGGW
GGGGGGGWGGOGGGGGGGGGGGGGGGGGGGGGOGGGW
GGGGGGGWGGGGGGGGGGGGGGGGGGGGGGGGGGGGW
GGGGGGGWWWWWWWWWWGGGGGGGGGGGGGGGGGGGW
GGGGGGGGGGGGGGGGGGGGGGGGOGGGGG*GGGGGW
GGGGGGGGGGGGGGGGGGGGGGGGGGGGGGGGGGGGW
GGGGGGOGGGGGGGGGGGGGGGGGGGWWWGGGGGGGW
GGGGGG*GGGGGGGGGGGGGGGGG*GGGGGGGGGGGW
GGGGGGGGGGGGGGGGGGGGGGGGGGGGGGGGGGGGW
GGGGGGGGGGGOGGGGGGGGGGGGOGGGGGGGGGGGW
GGGGGGGGGGG*GGGGGGGGGGGGGGGGGGGGGGGGW
GGGGGGGGGGGGGGGGGGGGGGGGGGGGGGGGGGGGW
WWWWWWWGGGWWWWWWWWWWWWWWWWWWWWWWWWWGW
GGGGGGGWWWGGGGGGGGG GGGGGGGGGGGGOGGGW
